100 100
1111111110111111101111111111011111111111111111111111111111111111110111111111111011111011111111111111
1000000000100000000010000000001000000000100000000010000000001000000000000000000010000000001000000000
1000000000100000000010000000001000000000100000000010000000000000000000100000000010000000001000000000
1000000000100000000010000000001000000000100000000010000000001000000000100000000010000000001000000000
0000000000100000000010000000001000000000100000000010000000001000000000100000000010000000001000000000
1000000000100000000010000000001000000000100000000000000000001000000000100000000010000000001000000000
1000000000100000000010000000001000000000100000000010000000001000000000100000000010000000001000000000
1000000000000000000010000000001000000000100000000010000000001000000000100000000000000000001000000000
1000000000100000000000000000001000000000100000000010000000001000000000100000000010000000001000000000
1000000000100000000010000000001000000000100000000010000000001000000000100000000010000000000000000000
1111111111111111011111110111111111011111111011111111111111101111111110111111110111111011111111110111
1000000000100000000010000000001000000000100000000010000000001000000000100000000010000000001000000000
1000000000000000000010000000001000000000000000000010000000000000000000100000000010000000001000000000
1000000000100000000010000000001000000000100000000010000000001000000000100000000010000000001000000000
1000000000100000000010000000001000000000100000000010000000001000000000100000000010000000001000000000
1000000000100000000010000000001000000000100000000010000000001000000000100000000010000000001000000000
1000000000100000000010000000001000000000100000000010000000001000000000100000000010000000001000000000
1000000000100000000000000000001000000000100000000010000000001000000000100000000010000000000000000000
1000000000100000000010000000001000000000100000000010000000001000000000100000000010000000001000000000
0000000000100000000010000000001000000000100000000000000000001000000000100000000000000000001000000000
1111111111111110111111111111011111101111111111110111111101111110111111111111111111111111111111111011
1000000000100000000010000000001000000000100000000010000000001000000000000000000010000000001000000000
1000000000100000000010000000001000000000100000000010000000000000000000100000000010000000001000000000
1000000000100000000010000000001000000000100000000000000000001000000000100000000010000000001000000000
0000000000100000000010000000001000000000100000000010000000001000000000100000000010000000000000000000
1000000000100000000010000000001000000000000000000010000000001000000000100000000010000000001000000000
1000000000100000000010000000001000000000100000000010000000001000000000100000000010000000001000000000
1000000000100000000010000000001000000000100000000010000000001000000000100000000010000000001000000000
1000000000000000000010000000001000000000100000000010000000001000000000100000000010000000001000000000
1000000000100000000010000000001000000000100000000010000000001000000000100000000010000000001000000000
1111101111111011111111111111111111111111101111111111111011111111111101111110111111110111111101111111
1000000000100000000010000000001000000000100000000010000000001000000000100000000010000000001000000000
1000000000100000000010000000001000000000100000000010000000001000000000100000000010000000001000000000
1000000000100000000010000000001000000000100000000010000000001000000000100000000010000000001000000000
1000000000100000000010000000001000000000100000000010000000001000000000100000000010000000001000000000
1000000000100000000000000000001000000000100000000010000000000000000000100000000010000000001000000000
0000000000100000000010000000001000000000100000000010000000001000000000100000000000000000001000000000
1000000000000000000010000000001000000000100000000010000000001000000000100000000010000000001000000000
1000000000100000000010000000001000000000100000000010000000001000000000100000000010000000001000000000
1000000000100000000010000000000000000000100000000010000000001000000000000000000010000000001000000000
1110111111110111111111111111011111111101111111110111101111111111111111111111111111110111111111110111
1000000000100000000010000000001000000000100000000010000000001000000000100000000010000000001000000000
1000000000000000000010000000001000000000100000000010000000000000000000100000000010000000001000000000
1000000000100000000010000000001000000000100000000000000000001000000000100000000000000000001000000000
1000000000100000000010000000001000000000000000000010000000001000000000100000000010000000000000000000
1000000000100000000010000000001000000000100000000010000000001000000000100000000010000000001000000000
1000000000100000000010000000001000000000100000000010000000001000000000100000000010000000001000000000
1000000000100000000010000000001000000000100000000010000000001000000000100000000010000000001000000000
1000000000100000000010000000001000000000100000000010000000001000000000100000000010000000001000000000
0000000000100000000000000000001000000000100000000010000000001000000000100000000010000000001000000000
1011111111111011111111110111111101111111111111111111110111111111011111111011111111101111111111110111
0000000000100000000010000000001000000000100000000010000000001000000000100000000010000000001000000000
1000000000100000000010000000001000000000100000000000000000001000000000100000000010000000001000000000
1000000000100000000010000000001000000000100000000010000000001000000000100000000010000000001000000000
1000000000100000000010000000001000000000000000000010000000001000000000000000000010000000001000000000
1000000000100000000010000000000000000000100000000010000000001000000000100000000010000000000000000000
1000000000000000000010000000001000000000100000000010000000001000000000100000000010000000001000000000
1000000000100000000010000000001000000000100000000010000000000000000000100000000010000000001000000000
1000000000100000000010000000001000000000100000000010000000001000000000100000000010000000001000000000
1000000000100000000010000000001000000000100000000010000000001000000000100000000010000000001000000000
1101111111111110111111111011111110111111111111111111111101111111111110111111110110111111111011111111
1000000000100000000010000000001000000000100000000010000000001000000000100000000010000000001000000000
1000000000100000000010000000000000000000100000000010000000000000000000100000000010000000001000000000
1000000000000000000010000000001000000000100000000010000000001000000000000000000010000000001000000000
1000000000100000000010000000001000000000100000000010000000001000000000100000000010000000001000000000
1000000000100000000010000000001000000000100000000010000000001000000000100000000000000000001000000000
1000000000100000000010000000001000000000100000000010000000001000000000100000000010000000000000000000
1000000000100000000010000000001000000000100000000010000000001000000000100000000010000000001000000000
0000000000100000000010000000001000000000100000000010000000001000000000100000000010000000001000000000
1000000000100000000010000000001000000000100000000000000000001000000000100000000010000000001000000000
1111111011111111111111111110111111101111111111111011101111111101111111111110111111110111111011111111
1000000000100000000010000000001000000000000000000010000000001000000000100000000010000000001000000000
1000000000100000000010000000001000000000100000000010000000001000000000000000000010000000001000000000
1000000000100000000010000000001000000000100000000010000000001000000000100000000010000000001000000000
1000000000100000000010000000001000000000100000000010000000001000000000100000000010000000001000000000
1000000000100000000010000000001000000000100000000010000000001000000000100000000010000000001000000000
1000000000100000000010000000001000000000100000000000000000001000000000100000000010000000001000000000
1000000000100000000010000000000000000000100000000010000000000000000000100000000010000000001000000000
1000000000100000000010000000001000000000100000000010000000001000000000100000000010000000000000000000
1000000000100000000010000000001000000000100000000010000000001000000000100000000010000000001000000000
1111011111111111111011111111101111101111111011111111111011111111111111111111011111111011111111110111
1000000000100000000010000000000000000000000000000010000000001000000000100000000010000000001000000000
1000000000100000000010000000001000000000100000000010000000001000000000100000000010000000001000000000
1000000000100000000010000000001000000000100000000010000000001000000000100000000000000000001000000000
1000000000100000000010000000001000000000100000000010000000001000000000100000000010000000000000000000
1000000000100000000010000000001000000000100000000010000000001000000000000000000010000000001000000000
1000000000100000000010000000001000000000100000000000000000001000000000100000000010000000001000000000
0000000000000000000010000000001000000000100000000010000000001000000000100000000010000000001000000000
1000000000100000000010000000001000000000100000000010000000001000000000100000000010000000001000000000
1000000000100000000000000000001000000000100000000010000000001000000000100000000010000000001000000000
1111110111111110111111111111101011111111111111110111110111111101111111101111111111111111101101111111
1000000000100000000000000000001000000000100000000010000000001000000000100000000010000000001000000000
1000000000100000000010000000001000000000000000000010000000001000000000100000000010000000001000000000
0000000000100000000010000000001000000000100000000010000000001000000000100000000010000000001000000000
1000000000100000000010000000001000000000100000000010000000001000000000100000000010000000001000000000
1000000000100000000010000000001000000000100000000010000000001000000000100000000010000000001000000000
1000000000100000000010000000000000000000100000000010000000001000000000100000000010000000001000000000
1000000000000000000010000000001000000000100000000010000000000000000000100000000010000000001000000000
1000000000100000000010000000001000000000100000000010000000001000000000100000000000000000001000000000
1000000000100000000010000000001000000000100000000000000000001000000000100000000010000000001000000000
