101 101
1 1
2 2
00000000010000000100000000001000000000000000000000000000000000000010000000000001000001000000000000000
01111111110111111111011111111101111111110111111111011111111101111111111111111111011111111101111111110
01111111110111111111011111111101111111110111111111011111111111111111110111111111011111111101111111110
01111111110111111111011111111101111111110111111111011111111101111111110111111111011111111101111111110
11111111110111111111011111111101111111110111111111011111111101111111110111111111011111111101111111110
01111111110111111111011111111101111111110111111111111111111101111111110111111111011111111101111111110
01111111110111111111011111111101111111110111111111011111111101111111110111111111011111111101111111110
01111111111111111111011111111101111111110111111111011111111101111111110111111111111111111101111111110
01111111110111111111111111111101111111110111111111011111111101111111110111111111011111111101111111110
01111111110111111111011111111101111111110111111111011111111101111111110111111111011111111111111111110
00000000000000001000000010000000001000000001000000000000000100000000010000000010000001000000000010000
01111111110111111111011111111101111111110111111111011111111101111111110111111111011111111101111111110
01111111111111111111011111111101111111111111111111011111111111111111110111111111011111111101111111110
01111111110111111111011111111101111111110111111111011111111101111111110111111111011111111101111111110
01111111110111111111011111111101111111110111111111011111111101111111110111111111011111111101111111110
01111111110111111111011111111101111111110111111111011111111101111111110111111111011111111101111111110
01111111110111111111011111111101111111110111111111011111111101111111110111111111011111111101111111110
01111111110111111111111111111101111111110111111111011111111101111111110111111111011111111111111111110
01111111110111111111011111111101111111110111111111011111111101111111110111111111011111111101111111110
11111111110111111111011111111101111111110111111111111111111101111111110111111111111111111101111111110
00000000000000010000000000001000000100000000000010000000100000010000000000000000000000000000000001000
01111111110111111111011111111101111111110111111111011111111101111111111111111111011111111101111111110
01111111110111111111011111111101111111110111111111011111111111111111110111111111011111111101111111110
01111111110111111111011111111101111111110111111111111111111101111111110111111111011111111101111111110
11111111110111111111011111111101111111110111111111011111111101111111110111111111011111111111111111110
01111111110111111111011111111101111111111111111111011111111101111111110111111111011111111101111111110
01111111110111111111011111111101111111110111111111011111111101111111110111111111011111111101111111110
01111111110111111111011111111101111111110111111111011111111101111111110111111111011111111101111111110
01111111111111111111011111111101111111110111111111011111111101111111110111111111011111111101111111110
01111111110111111111011111111101111111110111111111011111111101111111110111111111011111111101111111110
00000100000001000000000000000000000000000100000000000001000000000000100000010000000010000000100000000
01111111110111111111011111111101111111110111111111011111111101111111110111111111011111111101111111110
01111111110111111111011111111101111111110111111111011111111101111111110111111111011111111101111111110
01111111110111111111011111111101111111110111111111011111111101111111110111111111011111111101111111110
01111111110111111111011111111101111111110111111111011111111101111111110111111111011111111101111111110
01111111110111111111111111111101111111110111111111011111111111111111110111111111011111111101111111110
11111111110111111111011111111101111111110111111111011111111101111111110111111111111111111101111111110
01111111111111111111011111111101111111110111111111011111111101111111110111111111011111111101111111110
01111111110111111111011111111101111111110111111111011111111101111111110111111111011111111101111111110
01111111110111111111011111111111111111110111111111011111111101111111111111111111011111111101111111110
00010000000010000000000000001000000000100000000010000100000000000000000000000000000010000000000010000
01111111110111111111011111111101111111110111111111011111111101111111110111111111011111111101111111110
01111111111111111111011111111101111111110111111111011111111111111111110111111111011111111101111111110
01111111110111111111011111111101111111110111111111111111111101111111110111111111111111111101111111110
01111111110111111111011111111101111111111111111111011111111101111111110111111111011111111111111111110
01111111110111111111011111111101111111110111111111011111111101111111110111111111011111111101111111110
01111111110111111111011111111101111111110111111111011111111101111111110111111111011111111101111111110
01111111110111111111011111111101111111110111111111011111111101111111110111111111011111111101111111110
01111111110111111111011111111101111111110111111111011111111101111111110111111111011111111101111111110
11111111110111111111111111111101111111110111111111011111111101111111110111111111011111111101111111110
01000000000001000000000010000000100000000000000000000010000000001000000001000000000100000000000010000
11111111110111111111011111111101111111110111111111011111111101111111110111111111011111111101111111110
01111111110111111111011111111101111111110111111111111111111101111111110111111111011111111101111111110
01111111110111111111011111111101111111110111111111011111111101111111110111111111011111111101111111110
01111111110111111111011111111101111111111111111111011111111101111111111111111111011111111101111111110
01111111110111111111011111111111111111110111111111011111111101111111110111111111011111111111111111110
01111111111111111111011111111101111111110111111111011111111101111111110111111111011111111101111111110
01111111110111111111011111111101111111110111111111011111111111111111110111111111011111111101111111110
01111111110111111111011111111101111111110111111111011111111101111111110111111111011111111101111111110
01111111110111111111011111111101111111110111111111011111111101111111110111111111011111111101111111110
00100000000000010000000001000000010000000000000000000000100000000000010000000010010000000001000000000
01111111110111111111011111111101111111110111111111011111111101111111110111111111011111111101111111110
01111111110111111111011111111111111111110111111111011111111111111111110111111111011111111101111111110
01111111111111111111011111111101111111110111111111011111111101111111111111111111011111111101111111110
01111111110111111111011111111101111111110111111111011111111101111111110111111111011111111101111111110
01111111110111111111011111111101111111110111111111011111111101111111110111111111111111111101111111110
01111111110111111111011111111101111111110111111111011111111101111111110111111111011111111111111111110
01111111110111111111011111111101111111110111111111011111111101111111110111111111011111111101111111110
11111111110111111111011111111101111111110111111111011111111101111111110111111111011111111101111111110
01111111110111111111011111111101111111110111111111111111111101111111110111111111011111111101111111110
00000001000000000000000000010000000100000000000001000100000000100000000000010000000010000001000000000
01111111110111111111011111111101111111111111111111011111111101111111110111111111011111111101111111110
01111111110111111111011111111101111111110111111111011111111101111111111111111111011111111101111111110
01111111110111111111011111111101111111110111111111011111111101111111110111111111011111111101111111110
01111111110111111111011111111101111111110111111111011111111101111111110111111111011111111101111111110
01111111110111111111011111111101111111110111111111011111111101111111110111111111011111111101111111110
01111111110111111111011111111101111111110111111111111111111101111111110111111111011111111101111111110
01111111110111111111011111111111111111110111111111011111111111111111110111111111011111111101111111110
01111111110111111111011111111101111111110111111111011111111101111111110111111111011111111111111111110
01111111110111111111011111111101111111110111111111011111111101111111110111111111011111111101111111110
00001000000000000001000000000100000100000001000000000001000000000000000000001000000001000000000010000
01111111110111111111011111111111111111111111111111011111111101111111110111111111011111111101111111110
01111111110111111111011111111101111111110111111111011111111101111111110111111111011111111101111111110
01111111110111111111011111111101111111110111111111011111111101111111110111111111111111111101111111110
01111111110111111111011111111101111111110111111111011111111101111111110111111111011111111111111111110
01111111110111111111011111111101111111110111111111011111111101111111111111111111011111111101111111110
01111111110111111111011111111101111111110111111111111111111101111111110111111111011111111101111111110
11111111111111111111011111111101111111110111111111011111111101111111110111111111011111111101111111110
01111111110111111111011111111101111111110111111111011111111101111111110111111111011111111101111111110
01111111110111111111111111111101111111110111111111011111111101111111110111111111011111111101111111110
00000010000000010000000000000101000000000000000010000010000000100000000100000000000000000100100000000
01111111110111111111111111111101111111110111111111011111111101111111110111111111011111111101111111110
01111111110111111111011111111101111111111111111111011111111101111111110111111111011111111101111111110
11111111110111111111011111111101111111110111111111011111111101111111110111111111011111111101111111110
01111111110111111111011111111101111111110111111111011111111101111111110111111111011111111101111111110
01111111110111111111011111111101111111110111111111011111111101111111110111111111011111111101111111110
01111111110111111111011111111111111111110111111111011111111101111111110111111111011111111101111111110
01111111111111111111011111111101111111110111111111011111111111111111110111111111011111111101111111110
01111111110111111111011111111101111111110111111111011111111101111111110111111111111111111101111111110
01111111110111111111011111111101111111110111111111111111111101111111110111111111011111111101111111110
00000000000000000000000000000000000000000000000000000000000000000000000000000000000000000000000000000